5 11
XXXXXXXXXXX
X@  XXX   X
X * X  *  X
X     .XX.X
XXXXXXXXXXX
